NO mandatory/textures/cavewall.xpm
SO mandatory/textures/cavewall.xpm
WE mandatory/textures/cavewall.xpm
EA mandatory/textures/cavewall.xpm

F 138,138,138
C 0,0,0


        1111111111111111111111111
        1000000000110000000000001
        1011000001110000000000001
        1001000000000000000000001
111111111011000001110011111111111
10000000000111111   11     11
100000000011000001110111111111111
11111111101111111   1
111111111E11
111111111011
         1
                        