NO bonus/textures/BRICK_3D.xpm
SO bonus/textures/BRICK_3B.xpm
WE bonus/textures/BRICK_6D.xpm
EA bonus/textures/BRICK_1A.xpm
EN bonus/textures/enemy_jaurel.xpm

F 138,138,138
C 0,0,0


                1      1         1
11111111111111110111111011111111111
1N000000000000000000000000000000001
11111111111111112111111211111111111
10000000000000000100000000000000001
10000000000000000100000000000000001
10000000000000000100000000000000001
 100000000000000010000000000000001111
  10000000111100000001000000000000001
   1000000000000010000000000000111111
    100000000000000000000000001
     1000000000000000000000001
      10000000000000000000001
       100000000000000000001
        1000000000000000001
         10000000000000001
          100000000000001
           1000000000001
            10000000001
             100000001
              1000001
               10001
                101
                 1





