NO bonus/textures/376.xpm
SO bonus/textures/376.xpm
WE bonus/textures/376.xpm
EA bonus/textures/376.xpm

F 139,0,0
C 15,255,255

        1111111111111111111111111
        1000000000110000000000001
        1011000001100000000000001
        1001000E00020000000000001
111111111011000001110000000000001
100000000011000001112111111111111
11110111111111211100000010001
11110111111111011101010000001
11000000110101011100000010001
10000000000000001100000010001
10000000000000001101010010001
1100000111010101111101111000111
11110001 1110101 101111010001
11111111 1111111 111111111111
