NO bonus/textures/376.xpm
SO bonus/textures/376.xpm
WE bonus/textures/376.xpm
EA bonus/textures/376.xpm
EN bonus/textures/enemy_jaurel.xpm

F 139,0,0
C 15,255,255

        1111111111111111111111111
        100000S000110000000000001
        1011000001110000000000001
        100100H00020000000000001
111111111011000001110000000000001
100000000011000001112111111111111
11110111111111211100000010001
11110111111111011101010000001
11000000110101011100000010001
100000000000H0001100000010001
100000000000H0001101010010001
110000011101H101111101111000111
11H10001 1110101 101111010001
11111111 1111111 111111111111
