NO bonus/textures/CONSOLE_1B.xpm
SO bonus/textures/CRATE_2C.xpm
WE bonus/textures/LAB_2B.xpm
EA bonus/textures/TECH_4E.xpm
EN bonus/textures/enemy_jaurel.xpm



F 200,200,200
C 138,138,138



        11111
        100H1111111111111111111111
        10010000001100000000000H1
        1001000001110000000100001
        1001000000000000N00000001
1111111110010000011100000000000H1
1H0000000020000001112111100011111
11110111111111211100000010001111
11110111111111011101210010H01
11000000110101011100000010001
10000000000000000200H00010001
10000000000000000200000010001
110000H11101000111000110100011
11110001 1110001 101111H10001
11111111 1111111 1111111H0111
                        11