NO bonus/textures/cavewall.xpm
SO bonus/textures/376.xpm
WE bonus/textures/cavewall.xpm
EA bonus/textures/376.xpm
EN bonus/textures/enemy_jaurel.xpm

F 138,138,138
C 0,0,0


111111
1HN0H1
111111
